1111111111111111111111111
11111111111P1111111111111
1M00001111101M00011111E11
1E0M110000000001100000011
100M0000M001C000000000M11
10C00M00000100M0000000111
1000000000M10000000000M11
1000M0C00001000M010000111
1C00C0M00M010M0C111110101
1111111111111111111111111