1111111111111111111111111
11111111111P1111111111111
1M000011111C1M00011111E11
1E0M1100000E0001100000011
100M0000M0010000000000M11
10000M00000100M0000000111
1000000000M10000000000M11
1000M0000001000M010000111
100000M00M010M00111110101
1111111111111111111111111