1111111111111111111111111
11111111111P1111111111111
1M00001111101M00011111E11
1000110000000001100000011
10000000M001C000000000111
10C00M000001M0MMM00000111
1000000000M1000000M00M111
100000C000010000000CC0111
100000M000010M00111110101
1111111111111111111111111