1111111111111111111111111
11111011111P1111111111111
1M000C1111101M00C01111E11
1E0M100M000000011000M0011
100M00C0M001C000000000M11
10C00M000001C0M000000C111
1000000000M10000000000M11
1000M0C00001000M01000C111
1C00C0000MC10M0C11111C101
1111111111111111111111111