1111111111111111111111111
11111111111P1111111111111
10000C1111101000C11111E11
1000110000000001100000C11
100000000001C000000000111
100000C000010000E00000111
1000000000010000000000111
1000000000010000000000111
10000C000001000011111C111
1111111111111111111111111