1111111111111111111111111
11111111111P1111111111111
1000001111101000011111E11
1000110000000001100000011
100000000001C000000000111
1000000000010000E00000111
1000000000010000000000111
1000000000010000000000111
1000000000010000111110101
1111111111111111111111111