11111111111111111111111111
1EEP0C0000001CCCCCCCCCCC11
1CCCCCCCCCCC1CCCCCCCCCCC11
1CCCCCCCCCCC1CCCCCCCCCCC11
1CCCCCCCCCCC1CCCCCCCCCCC11
1CCCCCCCCCCC1CCCCCCCCCCC11
1CCCCCCCCCCC0CCCCCCCCCCC11
11111111111111111111111111