1111;111111111111111x1111
11111111111P1111111111111
100v001111101;00011111E11
100011o000000000110000001
100000000001C/00000000111
10C0000000010000E00000111
10p000000001000000a000111
100000C0@0010000000CC0-11
10-00000000*000011c110101
1111111111111111111111111